#################################################
s                                    #          #
#####     #             ##    ...    ###        #
#   #     #          ### #    .#.      #     ####
# ###.......... .........#.....#...           ..#
#         #   ########   #     #  .          ####
#             . .        ##### #  ....       .  #
#             ...        #     #     .........  #
##########################x######################