#################################################
#                        #       @@  #          #
#         #              #    %B  @  ###        #
#         #              #    %#  @    #    B   #
x         #              A    %#       #@@@@@@@ s
#         #              A    %#       @@   B   #
#                        A    %#                #
#                 %%%       %%%#                #
#################################################