##########
x........s
#        #
#        #
##########