##########
x::::::::s
#        #
#        #
##########