#################################################
#                              #     #          #
# ###     #             ##     #     ###        #
#        #   ###    ### #     #     ::::    # ###
# ###                    #     #    :  :   :::::s
#        #############   #     #:::::  :   : ####
#                        # ### #:      :::::    #
#                        #      :::             #
##################################x##############
