#################################################
#                              #     #          #
# ###     #             ##     #     ###        #
x        #   ###    ### #     #       #     # ###
# ###                    #     #                s
#        #############   #     #             ####
#                        # ### #                #
#                        #                      #
#################################################